GROUP_NAME	Plan_Type
ERIKA TRAVEL INSURANCE, LTD	TV
ASCENSION	TV
ASSURED ASSISTANCE, INC (RBC)	TV
BEST DOCTORS	TV
CMN GLOBAL, INC	TV
CULTURAL INSURANCE SERVICE INTERNATIONAL	TV
ELC	TV
EQUIAN	TV
GMMI, INC.	TV
GOODHEALTH	TV
HTH WORLDWIDE	TV
NEW FRONTIER GROUP	TV
NEW FRONTIER GROUP 2	TV
NHSI-VUMI GROUP	TV
OLYMPUS MANAGED HEALTH CARE, INC.	TV
PAYER FUSION	TV
REDBRIDGE	TV
SELECT CARE	TV
SUMMIT OPEN HEALTH PLUS	TV
WORLD TRAVEL PROTECTION	TV
CONTRACEPTIVE SERVICES PAYMENT PROGRAM	TV
WINDSTREAM SERVICES, LLC	CR
AETNA STUDENT HEALTH - MEDICAL - ALIC	OT
COSTCO WHOLESALE CORPORATION	OT
EPAM SYSTEMS, INC.	OT
HOME DEPOT U.S.A., INC.	OT
MERCEDES-BENZ U.S. INTERNATIONAL, INC.	OT
PHILADELPHIA ACADEMIC HEALTH SYSTEM, LLC	OT
STEELCASE INC.	OT
THE SCHOOL BOARD OF VOLUSIA COUNTY	OT
UBS FINANCIAL SERVICES INC.	OT
INTERNATIONAL ASSOCIATION OF MACHINIST AND        AEROSPACE WORKERS	OT
AUTONATION, INC. C/O AUTONATION BENEFITS COMPANY	OT